————————————————————————————————————————————————————————————
|                                                          |
|                                                          |
|                                                          |
|                                                          |
|                                                          |
|                                                          |
|            ————————                                      |
|            |                                             |
|            |   R                                         |
|            |                                             |
|                                                          |
|                                                          |
|                                                          |
|                         |                                |
|                         |                                |
|                    —————|—————                           |
|                         |                                |
|                         |                                |
|                                                          |
|                                                          |
|                                            |             |
|                                            |             |
|                                            |             |
|                                            |             |
|                                  ———————————             |
|                                                          |
|                                                          |
|                                                          |
|                                                          |
|                                                          |
|                                                          |
|                                                          |
————————————————————————————————————————————————————————————
